______4______
_____404_____
____40004____
____40004____
____55555____
__6__404__6__
_6_6_404_6_6_
__6__404__6__
_____404_____
_____404_____
_____404_____
____44044____
___4000004___
__434000434__
__434444434__
__434___434__
__434___434__
__434___434__